0 0 0 0 0 0 0 0 0 0 0 0 0 0 0 0 0 0 0 0 0 0 0 0 0 0 0 0
0 0 0 0 0 0 0 0 0 0 0 0 0 0 0 0 0 0 0 0 0 0 0 0 0 0 0 0
0 0 0 0 0 0 0 0 0 0 0 0 0 0 0 0 0 0 0 0 0 0 0 0 0 0 0 0
0 0 0 0 0 0 0 0 0 0 0 0 0 0 0 0 0 0 0 0 0 0 0 0 0 0 0 0
0 p p p p p p p p p p p p 0 0 p p p p p p p p p p p p 0
0 p 0 0 0 0 p 0 0 0 0 0 p 0 0 p 0 0 0 0 0 p 0 0 0 0 p 0
0 P 0 0 0 0 p 0 0 0 0 0 p 0 0 p 0 0 0 0 0 p 0 0 0 0 P 0
0 p 0 0 0 0 p 0 0 0 0 0 p 0 0 p 0 0 0 0 0 p 0 0 0 0 p 0
0 p p p p p p p p p p p p p p p p p p p p p p p p p p 0
0 p 0 0 0 0 p 0 0 p 0 0 0 0 0 0 0 0 p 0 0 p 0 0 0 0 p 0
0 p 0 0 0 0 p 0 0 p 0 0 0 0 0 0 0 0 p 0 0 p 0 0 0 0 p 0
0 p p p p p p 0 0 p p p p 0 0 p p p p 0 0 p p p p p p 0
0 0 0 0 0 0 p 0 0 0 0 0 | 0 0 | 0 0 0 0 0 p 0 0 0 0 0 0
0 0 0 0 0 0 p 0 0 0 0 0 | 0 0 | 0 0 0 0 0 p 0 0 0 0 0 0
0 0 0 0 0 0 p 0 0 + - - + - - + - - + 0 0 p 0 0 0 0 0 0
0 0 0 0 0 0 p 0 0 | 0 0 0 0 0 0 0 0 | 0 0 p 0 0 0 0 0 0
0 0 0 0 0 0 p 0 0 | 0 0 0 0 0 0 0 0 | 0 0 p 0 0 0 0 0 0
+ - - - - - p - - + 0 0 0 0 0 0 0 0 + - - p - - - - - +
0 0 0 0 0 0 p 0 0 | 0 0 0 0 0 0 0 0 | 0 0 p 0 0 0 0 0 0
0 0 0 0 0 0 p 0 0 | 0 0 0 0 0 0 0 0 | 0 0 p 0 0 0 0 0 0
0 0 0 0 0 0 p 0 0 + - - - - - - - - + 0 0 p 0 0 0 0 0 0
0 0 0 0 0 0 p 0 0 | 0 0 0 0 0 0 0 0 | 0 0 p 0 0 0 0 0 0
0 0 0 0 0 0 p 0 0 | 0 0 0 0 0 0 0 0 | 0 0 p 0 0 0 0 0 0
0 p p p p p p p p p p p p 0 0 p p p p p p p p p p p p 0
0 p 0 0 0 0 p 0 0 0 0 0 p 0 0 p 0 0 0 0 0 p 0 0 0 0 p 0
0 p 0 0 0 0 p 0 0 0 0 0 p 0 0 p 0 0 0 0 0 p 0 0 0 0 p 0
0 P p p 0 0 p p p p p p p - - p p p p p p p 0 0 p p P 0
0 0 0 p 0 0 p 0 0 p 0 0 0 0 0 0 0 0 p 0 0 p 0 0 p 0 0 0
0 0 0 p 0 0 p 0 0 p 0 0 0 0 0 0 0 0 p 0 0 p 0 0 p 0 0 0
0 p p p p p p 0 0 p p p p 0 0 p p p p 0 0 p p p p p p 0
0 p 0 0 0 0 0 0 0 0 0 0 p 0 0 p 0 0 0 0 0 0 0 0 0 0 p 0
0 p 0 0 0 0 0 0 0 0 0 0 p 0 0 p 0 0 0 0 0 0 0 0 0 0 p 0
0 p p p p p p p p p p p p p p p p p p p p p p p p p p 0
0 0 0 0 0 0 0 0 0 0 0 0 0 0 0 0 0 0 0 0 0 0 0 0 0 0 0 0
0 0 0 0 0 0 0 0 0 0 0 0 0 0 0 0 0 0 0 0 0 0 0 0 0 0 0 0
0 0 0 0 0 0 0 0 0 0 0 0 0 0 0 0 0 0 0 0 0 0 0 0 0 0 0 0
